
  ################################################################################
  #                  #      #                            #        #              #
  #      ######      #      #######           #          #        #              #
  #######            #             #     ######          #        #       #      #
  #                 #       #             #    #                   # #####       #
  #   ###########            #     M       #          ########      #            #
  #   #          #     ###########    #     #        #        #     #            #
  ########     ###     #          #    #     ########          #    #            #
  #       #       #    #           #    #####        #          #### #           #
  #       #            #      #                      #                           #
  #   #                #      #     #                                       M    #
  #   #           M     #      #############    #       ##      #### #           #
  ########## ####        #      #        #     #        # #   ##    #            #
  #         #    #              #        #     #   M    #  ###      #            #
  #         #     #             #       #       #       #    #      #            #
  #######   #      ####      ######    #        #            #     # #####       #
  #   #     #      #         #        #    #    #                 #       #      #
  #             ####         #         #########       #          #              #
  #                           #                       #           #              #
  ################################################################################